7 7 7 7 7 7 7 7 7 7 7 7 7 7 7 7 7 7 7 7 7 7 7 7 7 7 7
7 7 7 7 7 7 7 7 7 7 7 7 7 7 7 7 7 7 7 7 7 7 7 7 7 7 7
7 7 7 7 7 0 0 0 0 0 0 0 3 3 3 3 3 3 3 3 7 7 7 7 7 7 7
7 7 7 0 0 0 0 0 0 0 0 0 2 2 2 2 2 3 3 3 2 7 7 7 7 7 7
7 7 0 0 0 0 0 0 0 0 0 0 0 0 0 0 0 2 2 2 0 7 7 7 7 7 7
7 7 0 0 0 0 0 0 0 0 0 0 0 0 0 0 0 0 0 0 0 7 7 7 7 7 7
0 0 0 0 0 0 5 5 5 5 5 5 5 5 5 5 5 4 0 0 0 7 7 7 7 7 7
7 7 7 7 7 0 0 0 0 0 0 0 0 0 0 0 0 6 0 0 0 7 7 7 7 7 7
7 7 7 0 0 0 0 0 0 0 0 0 0 0 0 0 0 6 0 0 0 7 7 2 2 2 7
7 7 0 0 0 0 0 0 0 0 0 0 0 0 0 0 0 6 0 0 0 0 0 0 0 1 7
7 7 0 0 0 0 0 0 0 0 0 0 0 0 0 0 0 6 0 0 0 0 0 0 0 1 7
7 7 0 0 0 0 0 0 0 0 0 0 0 0 0 0 0 0 0 0 0 7 7 2 2 2 7
7 7 7 3 3 3 3 3 3 3 3 3 3 0 0 0 0 0 4 0 7 7 7 7 7 7 7
7 7 7 7 7 2 2 2 2 2 0 0 0 0 0 0 0 4 4 0 7 7 7 7 7 7 7
7 7 7 7 7 7 7 7 7 7 7 7 7 7 7 7 7 7 7 7 7 7 7 7 7 7 7